################################################################################
#                                                                              #
#                                                                              #
#                                                                              #
#          #####                       #####                        #####      #
#          #   #                       #   #                        #   #      #
#          #####                       #####                        #####      #
#                                                                              #
#                                                                              #
#                                                                              #
#                                                                              #
#                                                                              #
#                                                                              #
#          #####                       #####                        #####      #
#          #   #                       #   #                        #   #      #
#          #####                       #####                        #####      #
#                                                                              #
#                                                                              #
#                                                                              #
################################################################################
